1111111111111111111111111111
1E00000000C0000C00000C000X01
1010010100100000101001010101
1010010010101010001001010101
1P000X000C00C000C00C00C000C1
1111111111111111111111111111
